NTSC	LITERAL1
PAL	LITERAL1

WHITE	LITERAL1
BLACK	LITERAL1
INVERT	LITERAL1

UP	LITERAL1
DOWN	LITERAL1
LEFT	LITERAL1
RIGHT	LITERAL1

TVoutEx		KEYWORD1
TVoutPrint	KEYWORD1

clearScreen	KEYWORD2
invert	KEYWORD2

begin	KEYWORD2
end	KEYWORD2
hres	KEYWORD2
vres	KEYWORD2
bufferSize	KEYWORD2
charLine	KEYWORD2
fill	KEYWORD2
delay	KEYWORD2
delayFrame	KEYWORD2
millis	KEYWORD2
setPixel	KEYWORD2
getPixel	KEYWORD2
fill	KEYWORD2
shift	KEYWORD2
drawLine	KEYWORD2
drawRow	KEYWORD2
drawColumn	KEYWORD2
drawRect	KEYWORD2
drawCircle	KEYWORD2
bitmap	KEYWORD2
set_vbi_hook	KEYWORD2
set_hbi_hook	KEYWORD2
tone	KEYWORD2
noTone	KEYWORD2
print_char	KEYWORD2
setCursor	KEYWORD2
selectFont	KEYWORD2
print	KEYWORD2
println	KEYWORD2
printPGM	KEYWORD2
